; Bombermaaan level file version=2
[Map]
Line.0 =	***************
Line.1 =	*1 --------- 3*
Line.2 =	* *****-***** *
Line.3 =	*-------------*
Line.4 =	*-***-***-***-*
Line.5 =	*-----   -----*
Line.6 =	*-*****5*****-*
Line.7 =	*-----   -----*
Line.8 =	*-***-***-***-*
Line.9 =	*-------------*
Line.10 =	* *****-***** *
Line.11 =	*4 --------- 2*
Line.12 =	***************
